......##....
............
....@........
............
.##....##...
...#........
##.......###
###.......##
............
............
............
