......##................
........................
....@...................
........................
.##....##...............
...#....................
##.......###............
###.......##............
........................
........................
........................